Start,3,1,,,,,,,,,
Goal,6,10,,,,,,,,,
Maze,,,,,,,,,,,
1,1,1,1,1,1,1,1,1,1,1,1
1,0,0,0,1,0,0,0,0,0,0,1
1,0,1,0,0,0,1,1,0,1,0,1
1,0,1,1,0,1,0,0,0,1,0,1
1,0,0,0,1,0,0,1,1,0,1,1
1,1,1,0,0,1,0,1,0,0,0,1
1,0,0,0,1,0,1,0,0,1,1,1
1,0,1,0,0,0,0,1,0,0,1,1
1,0,0,1,0,1,0,0,1,0,0,1
1,0,1,0,1,0,1,0,0,1,0,1
1,0,0,0,0,0,0,1,0,0,0,1
1,1,1,1,1,1,1,1,1,1,1,1