Start 1 5
Goal 4 4
Maze
1111111
1000001
1010101
1010011
1010101
1010001
1111111
