Start 1 5
Goal 3 5
Maze
1111111
1000001
1010111
1010001
1011101
1010001
1111111